********
*S******
*OOO****
*O*OO***
*O**OO**
*O***O**
*****G**
********